Name,MP,FG,FGA,FG.,X3P,X3PA,X3P.,X2P,X2PA,X2P.,FT,FTA,FT.,ORB,DRB,TRB,AST,STL,BLK,TOV,PF,PTS
#2 Shaylee Gonzales,800,185,360,0.5138888888888888,18,82,0.21951219512195122,167,278,0.6007194244604317,100,119,0.8403361344537815,50,99,149,115,63,7,62,47,488
#3 Nani Falatea,282,30,63,0.47619047619047616,20,39,0.5128205128205128,10,24,0.4166666666666667,4,6,0.6666666666666666,3,34,37,24,18,3,19,30,84
#4 Arielle MackeyWilliams,145,15,47,0.3191489361702128,5,20,0.25,10,27,0.37037037037037035,8,8,1,6,12,18,17,4,0,16,14,43
#5 Maria Albiero,702,49,125,0.392,16,52,0.3076923076923077,33,73,0.4520547945205479,5,7,0.7142857142857143,9,47,56,100,34,1,31,39,119
#10 Tegan Graham,741,94,214,0.4392523364485981,66,160,0.4125,28,54,0.5185185185185185,16,20,0.8,14,58,72,125,37,17,45,49,270
#11 Kaylee Smiler,240,15,40,0.375,8,27,0.2962962962962963,7,13,0.5384615384615384,6,8,0.75,4,20,24,19,9,3,7,19,44
#12 Lauren Gustin,709,127,242,0.5247933884297521,0,0,0,127,242,0.5247933884297521,27,56,0.48214285714285715,111,179,290,25,35,6,30,52,281
#13 Paisley Harding,774,162,346,0.4682080924855491,44,129,0.34108527131782945,118,217,0.543778801843318,80,98,0.8163265306122449,24,56,80,65,41,3,52,57,448
#20 Devry Millett,62,5,14,0.35714285714285715,1,6,0.16666666666666666,4,8,0.5,1,2,0.5,2,9,11,3,2,3,3,3,12
#21 Heather Hamson,0,0,0,0,0,0,0,0,0,0,0,0,0,0,0,0,0,0,0,0,0,0
#22 Sara Hamson,375,54,78,0.6923076923076923,0,2,0,54,76,0.7105263157894737,10,18,0.5555555555555556,25,62,87,13,13,65,27,60,118
#24 Rose Bubakar,119,16,43,0.37209302325581395,4,16,0.25,12,27,0.4444444444444444,8,12,0.6666666666666666,11,17,28,4,5,2,4,8,44
#25 Emma Calvert,207,40,82,0.4878048780487805,8,33,0.24242424242424243,32,49,0.6530612244897959,11,14,0.7857142857142857,18,30,48,12,3,17,21,33,99
#30 Kate Vorwaller,68,7,21,0.3333333333333333,2,6,0.3333333333333333,5,15,0.3333333333333333,3,6,0.5,4,7,11,8,4,0,2,5,19
